10 10 3
9 x y w h
0 3 0 1 7
0 1 7 5 1
0 3 8 1 2
9 6 5 1 4