10 10 7
9 x y w h
0 1 0 8 1
0 1 9 8 1
0 0 0 1 10
0 9 0 1 10
0 3 3 1 1
0 5 3 1 1
0 6 6 1 1