10 10 3
9 x y w h
9 1 0 8 1
9 1 9 8 1
9 0 0 1 10
9 9 0 1 10
0 3 3 1 1
0 5 3 1 1
0 6 6 1 1